#################
#..G..c...e..H..#
########.########
#..A..b...f..D..#
########@########
#..E..a...g..B..#
########.########
#..F..d...h..C..#
#################