......#..............#...#...................#...#...#....###...............#..#.....#.....###....##...#.....
.......#.....###.....##.##.####...###...#...##....#####..##.#...#...#.#.#...#....##.#.#...####....#.....#....
......#....##.#.##.#..#.###...##..#.##...####....###....##..###.##..#.#.####..#####..#.#.#.###...######..#...
....##..#...#.##..#####....#..#.#######..#...#.######.###..#.#.###.##.#.##.##.###.###.###...##...###.##..#...
...#####.###..##...####.####..#..#.#.#.##..#.....#.#.....##..#...#..#..#......#.#....##.#...#.#..#.##....##..
...###.#.###..###..#......########.#...##.##.####.#####.#.#.#...#...#..##.#.#...#..#....####..##...#.###.....
...#..#.#...##..#.#.....##.#.....#.####....#..........###.###.#..###....#..##....###.#.#..###..#.####.###....
...###....#.###.#.#..##...#.#..#..###.#.#..#.#..##..#.####.##.###.#....#..#.#.######.#.#...############......
...#....###.....#######.....#...#....#.#.#.#.....#.....##....#####.....#.##..##########....##..#.....#...#...
...##.##..#####..#..#.##.#######.###.#..#.####...#.##.#..#..###..###.#.#.##.###.##.#.###.##.#...###..##......
....#.......###....#.#.#.##.#..#..#.#.#.#.#.####.#.#.#####.####...#........#.###.##..#######.#...##.#..##....
...#....#.....###.#..#.##...#...##.###.......##.#.#####..#.#.#..#####..#...##.#.#..##..##.......#.#####......
....##...######.#..##.......####....#....##.#.#.#.#..#.###.##.#..###.##.#.....##....##.#.#..#.##.#..#.#..#...
.....#.####..##..#.##.#..####.###.####.#........#.##...#..#.###..##...#.#..#..#..#.....#..........#.#######..
....####...####..###..#...#......#.#.###.###.#####..#..##.###.##...#.#..####.#.####..#.########..#...#..##...
...#....#..#.#.#.#..#......#.###..#...##..##..#.###....##.#####.##.#..#...#.#####..#.#....#.....###...####...
...###.###..#..#....#.....#.###.#####..###.##..#.....#.##....#...##.##.#.#..#....##...#.#.###..#.#.#.#...##..
....#.###...#...##.####.####...#...#.#.###....#.....#.##...#..###.###..#..######..#....#.#.###...##.#.##.....
......#.#....#.#.#.###.###....#######..##....###.#.#..#...###.....###.#..#.#...##.##..##..#..##..#.#.#####...
.....####.##.###.#..##.#.###.#....#.....#####.##...###.####.#.######....#....#.##.#..#.#...##......#.#.......
....####.#...##.....#..#.###..###.##.####.##.#.#.....####..#.##...###..#...#####..########.##.####.....#.....
...####....####..#.##.###..#.##......#.#..#.###.#...#.##.####..####...###.###.###.##...#####.#.#.#..#.##.....
....#...###.#.#####...###..###..##.#.##.#.##.#.##..##.##.#..##.##.#.......###....#.#.#...#..########...####..
....##.#...#.#.#.#...#.#..##.##....##...#.####.#.#...#..#..##.#..####.#......####.#..##....##..#.#..#.##.#...
....###..##.###.#.#....##.#.#...#..#######....#....#.#...###.#.....##..##.#..##...#..#.##.#.##...##..#.###...
......#.#..#.....##.###..#..##....#...#.##.####.#.###..#.##.##..#.##..#.#.#...###...#.###..###.#.#..#..##....
.....#.##.#....#.#.#.##.....##..###..#####..#.##..##..#.#.#..#.###..###.##.......#..##...#.#.##...#..#..#....
....###....#.#.#.#..##..#.####...#....#...#####.#.###...#....##..###.#.###..##..##....#.#...#####...#........
....#..#...######...#..########.####.#...##....#.#.#.#..#####.####...####.#...#.#..#.###.##...##.#..#####.#..
...#......#.#.#.##.#.##.##...####.#.....##..#.#.##..#.##.######....#.###.##....#.##.#..##.#.##..#.#.####.....
....#####.#...#..##...###.###.###...###.#..#.#..#.##.###.###..#..###.##..#.##.####.#...#####.#.#...#..####...
......#..###..###.###..#...##.##..###.#..##..#.#..##..##..#...#...#....###....###.#.#.##..##...##.#...##.....
.....#.##.#.###.#..#..###..#.#.##..#.##..#.#..#....##..#####.#....#.##...#...##.#..##..###.#.#.#..#.#..#.....
....#.#.##.#...##......##..#....#####.....###.##.#..##..#.....#...#.##.....##.##.#.#.####...#.#...#..##......
.......###..##.#..#.##....#######..#..#.###..#.#..##.###.#.###.#...#.#.#..#.#.#.#.##.#.#..##..#.#..###..#.#..
...#.########..#.#..####.....#####..#...#...#...##.###.#.......#.#.####........####.#..###.##..##.#####.#....
...####...#...#.##...#.#.#.#.#.##..#..#....#..#..#.##...#.##.#....##....##.#...##..#..###....########..#.....
....#######....###...#.#.####.....#.#....##.##.##.##.#.#.##..####...###.#.#..##..##.##.#...#...#.......#.....
.....#.####..###....#...####......#..#...#.##.....###....#.#..####.########..#...#.#..##.#..#.##.#.#..####...
....#.....###..###.###..##..###.#####.#.##..#..#.#...##.#..##.####..#...##......#####.#.####.###.#..#..#.##..
...#########..#.##..#####.###.#####.##.##.######.##.#########.##....#.#.##..#.#.#####.#..###..##.#.####.##...
...####.###.......#####..##.#....####.#####.####.#.###.#.##.#######.##...#.#.#...##...#..#.####....#...#.#...
....###.###...##...##..#.##..##.#...##..###.##..#.###.####.####......####.#.#.###.######..######...##.#.#.#..
...#.##..#.#.....##.#...#.#..#.....#.....##.#..#...##.#..#.####.#.###.#.#.......###.#.#.#.##.#...#####..##...
....#....#.###..###.###.#..####.######..#.##..######..#.#...###.##....#.########..##.#..#.###..#####.....#...
......#.#....###...#.#.#...#..####.###...#..#...###..###.########.#..#####.....#..#..#..#....#.###.#..####...
.....###.#....#.#.....##.#..#..#...#.#...#.#.###.##..########...#...#....#......##..#.##..#..#..##.##.##.#...
.......#.#.#.###.##.#..#.....###..#####...#####...##....##...#..#...##..#.#.#....#.###..##..#.#.###.#...#.#..
....#.##......#..#.#.##..####.##.#...####.#..####...###.#.##...#...#.#####..#..###########..#......##...#....
....####.#.......##.#.##.###..#....#.##..###..##..##...####..#.###.###..#....#.##.####..####.###.###.##......
....#####.#..#..#.##..#.#..#....##..###..##.###....##....##....####..#..#..#.##..##....###..##.#.###...#.....
....###.#.##.###..#.###.#.#.##..##.###.#...#####.#.##.##.##...##...##.##.#..##.###.#.#.#.#...#.##.#####......
.....##.###.###.#..###.......#.#.#.....#..#.......#...###.#..#.#.###.#...######.#.....#.#..##.#...##.##.##...
...#.#.###.#..#..#...#...###.#.#....####..##...#..##...#..#...###..###..#.###.....#..#..##.#..#.#..#.#.#.##..
.....#.###.#...#.##.##.##..#.#.###...#.#..##.#..####..##...##.###...#....#...##..#...##..##..#..##..#.####...
....#.#...###.###.###.##..##..#..#.#..###.####...#..###....#..#.#....#.###..#.##.#.#.#.#...###.######....#...
....#.#.##....#####..#....##......#.###.######.#..#.#.##....####.###...#...##.##.#..##....####..#####.##.##..
...#######....##....#.#.#.##....#..#...#...####.#.#######.#.#..##.#.###.#..#..#....#.###....#.##..#..#.......
....#.##...#..#..#.####..#..#..#####....####....#....#..#..#.####.###.##.#.#..#.##.####.#.#.#.#..#..#........
.....###.###..###..##...#.......###.#...#.#...#.##..##.....###.##.#####...#####.......####..#..###.##.##.#...
....###...###.....#.#.###.#.###.#....#..##..#####.###...#..#.##...####..###..#.#..#.##....###.#.#.#####.###..
...######.###..#.###.#.....#.#.########.##..#..######...###.#....#.#.......#..#####.#..#..#....##..#.####....
.......#..#.#..#.###....#........##.##..###.#.#.#..######..#..#######....###....####...#.##...####..####.....
....#.......#.###..#.......#.#.#.##..#.#.....#.####.###.#..###...#....#.#######..#...#..#.#.....###...#......
...#####..########.###.###..#.#.##..##.#.#.#.##...#####..##..##..##.##.##..###..#...#....##..#######.#..#....
...##...#.###..####....#..##..##..#..#.#..#.....#.##..#.....##.#.#.####.##....###.##...###..#.##....##.##....
...##...####.......#.#.#.###..###..###.#.####..#..#...##..##...#.....#....#....#.#..##....#.##..#...##.#.....
...#####..#.#.....#.....#.#####..####......##..#..#...##.#######.#..##...###.##....#.######.##..#.#.#####....
...#..#.##..#.#...#...#.#..#####...#..##..#.#.####.###..#.####.##.....##..##.###.#.##..#...#.#.#.#.#.#..##...
...#.#.#..###..#...#.#.##.##########...#..##..##.###..##.#..##..#.#..##.#..#.#..##..#.....###..##..#.##......
...###.#..#.#..#.####.........##.#..#....##.#..#..#.....###.##..##.#.#.#.#.##.##....#..##.###...#..#..#......
...#.#####.#..####...#..####.##....##..#.#########......####...#..####.#..#######.#..###........#..###.###...
...#.#..........#......###.....#...###..###..#####.#####.#..#..#..####.##.#....###..#...#...#..#...####......
....#.#.###..##..#.#.####...#.#........#####....#.###.#.##.#..#..##..#.##.#.##..#.##.#.###..##.#....#.#......
...###..##.####.#.#.#.####.####..#.#.#.#.##.####.#...##..##.#####.#.#..#......#...#.###.##.#...###..####.#...
....#######....###..#..##.##....#.###.###...#.##..####.####..###....#.#####...####.##..#.#..####.#.##..###...
.....#..##.##.#....###.##.####.#........#..#.#.#..#..#######.#.##..##...##..##.....#..#.#.#.#..#..#..........
.......##..##.#.......#..##..#.#.....#..#.##...##.###...#.....#..#..............######.####.##.#.##.#.#.###..
.....##...#..#.#.#.####.#..####.######.....#.#..##...##.##..##...#...###.##.....#...####..#.#####..#.##.##...
...#...####....#..#.#.##...#.###.....##.##..#.#......#..#..#####..##########..##.#..#.####.#...#..#.....#....
......##..#.....###.#####.#...##.....##.#..##.#.#.#..#.###..#.####.#.....##.....#...#......#.###.##..#.......
......######..###......###........##.#..#.##...###....#.##.#...#..##.##..#####...#....##..##....##.###.####..
...##.#.#..###.#...#######......#.###......#.#######.#.###..###..####.######..##.#.#####..#.###.###..###.#...
...###....####.###.##.#.#.#..#.#..#..###.#.....#...##..#...#.#.#.....######.#.#...#.######.##########...##...
...##..##..###.####...#.....##.##.#####.##..#..###.##..#....###..#...##..##...###.....##.#..#.###....#.#.#...
...###.....#.##....#####..#..###..#.#..#.##.##....######.##......###...#..##...#...#.##..###..##......##.....
...#..#..##..####..#..#.#.##..#...##.....###.#.#....#..#####.###.#..##.###.#.###.##..##..##..#.#####.#.###...
...#.##.#.#.#.#.#.#..#.###..#.#..##.#.##..#..#######.###..##.#####...#..#......#...#.##.##.#####...##.#..#...
....#.######..####...##.###..##..#.####..#....##.#.#.#..###.#..##...#....##...###......#....#..##.#.###.###..
...#.#######.#.###.##....#..###...#.#.#.#..##.#.#..####.#..#..#....##...###..####..#####.###.#.#..#...#......
....##..###.###..##..###.##.##########....#..#..#...#.###...###.#.#...#.......#...#...###...###.###..#.......
......#.##.#......#.##..#.##..#.....#######.###.##.#...#..##..##...#...##.##.###......###.#.##..#.##..###....
......###.#.#.....#.#..#..#..#.#..#..##......#..####.##.##.##.####.#.##..######..#...#.##.#.#.#....#.#..#....
....###.#.##..####.##...##.###.....##.##...#.#...###.####.#..###....######..#...#.###....#...##..##.###......
....#.#...#.....###...##....#.##.##....#..###..##..#..####.###..####.##.###..##..####.##.##....##..#.##......
....###..#####...##.#...#.####...##.#.#.#..###.#####..##.#.##..#...#...##...#.#.##..#.#.#..##......#.###.....
...##.#.##.#.#.#.###..#.##..#.#.#.##..#..#####.######.....####...######.#...##.........#...##.......#..####..
.......#........##...##.#..##.###.#..#.######....#..#.#.#.###.#..##..##......##.#####.#.#.####..#...####.....
....#..##..####.#...#.#.#..#.##...#.#...##.####.#.########....##..#####....#.#.#.#.#..#.###....##.#####......
...#####..##.#.###.###...##..##.##..###.#...##.....##.###..##..#.#.#.....###..###...####..####.....#.#..#....
...#.##.#..##.#..#.####.#...#.##.####......###..#..#..#.#....##....##.##..##.###.#...###..#...####...##.#....
...##...#.##.#..#####.#.#.###.#..##..######.###..#....#.....##.###..#.##....####.####..##...#####.#....###...
........##..#..#..#..###.#.###..#.#.##....##...#..##...#.#.......#.#.....##.##..#.....#.....#....#..###......
...##.#..##..##.#..##.#...##.##.##.....##....##......##..##....##..##.#.##.##..##.#.#.....##...##.....##.....